NO assets/brick64.png
WE assets/grasss.png

F 8,58,47
C 0,0,0
C 0,191,255
F 32,139,34




1111111111111111111111111111111111111111111111
      1111100000100000000000000001000000000001
1111111000000000000111111100000000011111111111
100000010001110000010000011100011111
101000000000000000010000000000000001
100000000W011100000000000000000000011111111111
1100000001011100000100000000000000000000000001
1000000001000000000100000000000000011111111111
110000000100000000010000000011111101
100000000101110000010000000000000001
100000000001110000010000000000001111111111
100000000101110000010001100011111111
100000000101110000010001000000000001
100000000101110000011111111111111111
100000000000000000000000010111000001111111
1111111111000000111111111111111111110000011111
1000000000000000000000000000000000000000000001
1010101010101010101010101010101010110000111111111
1000000000000000000000000000000000000000000000001
1101010101010101010101010101010101011111111111111
100000000000000000000000000000000001
101010101010101010101010101010101011
100000000000000000000000000000000001
111111111111111111111111111111111111