EA assets/blue_wall.png

C 0,191,255
F 32,139,34

111111111111111111111111111111111111111111111111111111111111
1W0000000000000000000000000000000000000000000000000000000001
100000111111111111111111111111111111111111111111111111111111
100000111111111111111111111111111111111111111111111111111111
100000111111111111111111111111111111111111111111111111111111
100000111111111111111111111111111111111111111111111111111111
111111111111111111111111111111111111111111111111111111111111
