a

b

111111111111111111111111111111111111111111111111111111111111111111111111111111111111
1WW000000000000000000000000000000000000000000W00000000000000000000000000000000000001
111111111111111111111111111111111111111111111111111111111111111111111111111111111111