a

b

111111111111111111111111111111111
1W0000000000000000000000000000001
111111111111111111111111111111111
