a

b

11111111111111111111
10000000000000000101
10011000000000000001
10001001000111000001
10100000000000000001
10000000000111000001
10000111111110000001
10001111000000010001
10100000010010010001
10001000100000010001
10000000000000000W01
11111111111111111111
