EA assets/walls/qdenizar.png
NO assets/walls/cobblestone.png

F 8,58,47
C 0,0,0
C 0,191,255
F 32,139,34

1111111
1000001
1E00001
1000001
1111111
