1111111111111111111111111111111111111111111111111111111111111111111111111111111111111111111111
1E00000000000000000000000000000000000000000000000000000000000000000000000000000000000000000001
1111111111111111111111111111111111111111111111111111111111111111111111111111111111111111111111
