NO assets/purple_wall.png
EA assets/blue_wall.png
SO assets/black_wall.png

F 8,58,47
C 0,0,0
C 0,191,255
F 32,139,34

11111111111111111111111
10000000000000000000001
100000000E0000000000001
10000000000000000000001
10000000000000000000001
1111111111D111111111111
10000000000000000000001
10000000000000000000001
10000000000000000000001
10000000000000000000001
11111111111111111111111