a

b

111111111111111
100001101110111
100001101110111
100W01101110111
100001101110111
100001101110111
100001101110111
100001101110111
100001101110111
100001101110111
100001101110111
100001101110111
100001101110111
100001101110111
100001101110111
100001101110111
100001101110111
100001101110111
100001101110111
100001101110111
100001101110111
100001101110111
100001101110111111111
100001101110111111111111111111
100001101110111
100001101110111
100001101110111
100001101110111
100001101110111
111111111111111
1111