a

b

111111
100001
100001
10E001
111111