EA assets/walls/blackstone.png
SO assets/walls/budding_amethyst.png
WE assets/walls/carved_pumpkin.png
NO assets/walls/qdenizar.png

C 0,191,255
F 32,139,34

01011
10W01
10001
10001
11110