a

111111111111
100000000001
1000000W0001
111111111111
