NO assets/grasss.png
WE assets/grasss.png

F 8,58,47
C 0,0,0
C 0,191,255
F 32,139,34




111111111111111111111111111111111111
100000100000000000000001010000000001
111111100000000000011111110000000001
100000010001110000010000011100011111
101000000000000000010000000000000001
100000000W01110000000000000000000001
110000000101110000010000000000000001
100000000100000000010000000000000001
110000000100000000010000000011111101
100000000101110000010000000000000001
100000000001110000010000000000001111
100000000101110000010001100011111111
100000000101110000010001000000000001
100000000101110000011111111111111111
100000000000000000000000010111000001
111111111100000011111111111111111111
100000000000000000000000000000000001
101010101010101010101010101010101011
100000000000000000000000000000000001
110101010101010101010101010101010101
100000000000000000000000000000000001
101010101010101010101010101010101011
100000000000000000000000000000000001
111111111111111111111111111111111111