F 8,0,47
C 0,0,0
C 9,14,55
F 8,0,49










11111111111111111111
      10000000000000000101
11111100000000000001
10000001000111000001
10100000000000000001
100000000W0111000001
10000000010111000001
10000000010111000001
10000000010111000001
10000000010111000001
10000000010111000001
10000000010111000001
10000000010111000001
100000000101110000011111111111111111
100000000000000000000000010111000001
11111111111111111111111111111111111