NO assets/grasss.png
F 8,58,47
C 0,0,0
C 0,191,255
F 32,139,34




11111111111111111111111111
      10000000000000000101
11111110000000000001111111
10000001000111000001
10100000000000000001
100000000W0111000001
10000000010111000001
10000000010111000001
10000000010111000001
10000000010111000001
10000000010111000001
10000000010111000001
10000000010111000001
100000000101110000011111111111111111
100000000000000000000000010111000001
111111111111111111111111111111111111
