dfafad
EA assets/walls/blackstone.png
SO assets/walls/budding_amethyst.png
WE assets/walls/carved_pumpkin.png
NO assets/walls/cobblestone.png
dsa


rwerw
F 8,58,47
C 0,0,0
C 0,191,255
F 32,139,34
rwrewrw



1111111111111111111111111
10W0000001000000000000001
1010010011011001111101001
1010010010010000000100001
1010010010010111110101001
1010010010010100010001001
101001001Z010101010101001
1010010010010101010101001
1010000010010101010101001
1000010010000101010000001
1111000D11011101011111001
1000000000000001010000001
1010001111111101011101001
1010000000000001010101001
1010111001111111010101001
1010100000000000000101001
1010101000111111111101001
1010000000000000000001001
1011001001100111111101001
1000000000000000000001001
1011101110000000011101001
1010000000000000000000001
1000000000000000000000101
1111111111111111111111111