EA assets/blue_wall.png
SO assets/purple_wall.png
WE assets/black_wall.png
NO assets/pink_wall.png

C 0,191,255
F 32,139,34

111111111111111111111111
1E0000000100000000000001
101111000101111111110101
101001001001000000010001
101001001001011111010101
101001001001010001000101
101001001001010101010101
101001001001010101010101
101001001001010101010101
100001001000010101000001
111101111101110101111101
100000000000000101000001
101111111111110101110101
101000000000000101010101
101011111111111101010101
101010000000000000010101
101010111111111111110101
101000000000000000000101
101111111111111111110101
100000000000000000000101
101111111111111111110101
101000000000000000000001
101111111111111111111101
111111111111111111111111


