EA assets/walls/blackstone.png
SO assets/walls/budding_amethyst.png
WE assets/walls/carved_pumpkin.png
NO assets/walls/carved_pumpkin.png

C      0,191,255
F      32,139,34

                     1111111
1111111111111111111111000001
1000000000010000000100010001
100000010000000000001001000(
10E00000000100000000000111111
10000000000000000000000000001
10111111100000000000000010111
1000000110000000111111110001
11110000100000000000Z11000001
100001111000000011111100000001
1111000011111111111110000000001
1000000011111111111111111111111
100000001             1$1
 100000001            101
  100000001           101
   100000001          101
    100000001         101
     100000001        101
      100000001       101
       100000001      101
        100000001     101
         100000001111110111111
          10000000100000001001
           1000000010100000001
            100000001000000001
             10000000100001001
              1000000010100001
               100000001000001
                1000000010111
                 1000000001
                  100000001
                  111111111

















