EA assets/walls/blackstone.png
SO assets/walls/budding_amethyst.png
WE assets/walls/carved_pumpkin.png
NO assets/walls/tlassere.png

C 0,191,255
F 32,139,34

1110111111111111111111111
0W0000Z001000000000000000
1Z10010011011001111101001
1010010010010000000100001
1010010010010111110101001
1010010010010100010001001
101001001Z010101010101001
1010010010010101010101001
1010000010010101010101001
1000010010000101010000001
1111000Z11011101011111001
1000000000000001010000001
1010001111111101011101001
1010000000000001010101001
1010111001111111010101001
1010100000000000000101001
1010101000111111111101001
1010000000000000000001001
1011001001100111111101001
1000000000000000100001001
1011101110000000011101001
1010000000000000010100011
1000000000000000010000101
1110111111111111111111111